day	Algeria	Argentina	Australia	Austria	Belgium	Brazil	Canada	Chile	China	Colombia	Ecuador	Egypt	France	Germany	India	Indonesia	Iran	Israel	Italy	Japan	Mexico	Norway	Pakistan	Peru	Portugal	Russia	Saudi_Arabia	South_Africa	South_Korea	Spain	Sweden	Switzerland	Turkey	Ukraine	United_Kingdom	United_States	Total_Geral		
0	0	0	0	0	0	0	0	0	0	0	0	0	0	0	0	0	0	0	0	0	0	0	0	0	0	0	0	0	0	0	0	0	0	0	0	0	0		
1	0	0	0	0	0	0	0	0	0	0	0	0	0	0	0	0	0	0	0	0	0	0	0	0	0	0	0	0	0	0	0	0	0	0	0	0	0		
2	0	0	0	0	0	0	0	0	0	0	0	0	0	0	0	0	0	0	0	0	0	0	0	0	0	0	0	0	0	0	0	0	0	0	0	0	0		
3	0	0	0	0	0	0	0	0	0	0	0	0	0	0	0	0	0	0	0	0	0	0	0	0	0	0	0	0	0	0	0	0	0	0	0	0	0		
4	0	0	0	0	0	0	0	0	0	0	0	0	0	0	0	0	0	0	0	0	0	0	0	0	0	0	0	0	0	0	0	0	0	0	0	0	0		
5	0	0	0	0	0	0	0	0	0	0	0	0	0	0	0	0	0	0	0	0	0	0	0	0	0	0	0	0	0	0	0	0	0	0	0	0	0		
6	0	0	0	0	0	0	0	0	0	0	0	0	0	0	0	0	0	0	0	0	0	0	0	0	0	0	0	0	0	0	0	0	0	0	0	0	0		
7	0	0	0	0	0	0	0	0	0	0	0	0	0	0	0	0	0	0	0	0	0	0	0	0	0	0	0	0	0	0	0	0	0	0	0	0	0		
8	0	0	0	0	0	0	0	0	0	0	0	0	0	0	0	0	0	0	0	0	0	0	0	0	0	0	0	0	0	0	0	0	0	0	0	0	0		
9	0	0	0	0	0	0	0	0	0	0	0	0	0	0	0	0	0	0	0	0	0	0	0	0	0	0	0	0	0	0	0	0	0	0	0	0	0		
10	0	0	0	0	0	0	0	0	0	0	0	0	0	0	0	0	0	0	0	0	0	0	0	0	0	0	0	0	0	0	0	0	0	0	0	0	0		
11	0	0	0	0	0	0	0	0	1	0	0	0	0	0	0	0	0	0	0	0	0	0	0	0	0	0	0	0	0	0	0	0	0	0	0	0	1		
12	0	0	0	0	0	0	0	0	0	0	0	0	0	0	0	0	0	0	0	0	0	0	0	0	0	0	0	0	0	0	0	0	0	0	0	0	0		
13	0	0	0	0	0	0	0	0	0	0	0	0	0	0	0	0	0	0	0	0	0	0	0	0	0	0	0	0	0	0	0	0	0	0	0	0	0		
14	0	0	0	0	0	0	0	0	0	0	0	0	0	0	0	0	0	0	0	0	0	0	0	0	0	0	0	0	0	0	0	0	0	0	0	0	0		
15	0	0	0	0	0	0	0	0	1	0	0	0	0	0	0	0	0	0	0	0	0	0	0	0	0	0	0	0	0	0	0	0	0	0	0	0	1		
16	0	0	0	0	0	0	0	0	0	0	0	0	0	0	0	0	0	0	0	0	0	0	0	0	0	0	0	0	0	0	0	0	0	0	0	0	0		
17	0	0	0	0	0	0	0	0	0	0	0	0	0	0	0	0	0	0	0	0	0	0	0	0	0	0	0	0	0	0	0	0	0	0	0	0	0		
18	0	0	0	0	0	0	0	0	0	0	0	0	0	0	0	0	0	0	0	0	0	0	0	0	0	0	0	0	0	0	0	0	0	0	0	0	0		
19	0	0	0	0	0	0	0	0	1	0	0	0	0	0	0	0	0	0	0	0	0	0	0	0	0	0	0	0	0	0	0	0	0	0	0	0	1		
20	0	0	0	0	0	0	0	0	0	0	0	0	0	0	0	0	0	0	0	0	0	0	0	0	0	0	0	0	0	0	0	0	0	0	0	0	0		
21	0	0	0	0	0	0	0	0	3	0	0	0	0	0	0	0	0	0	0	0	0	0	0	0	0	0	0	0	0	0	0	0	0	0	0	0	3		
22	0	0	0	0	0	0	0	0	11	0	0	0	0	0	0	0	0	0	0	0	0	0	0	0	0	0	0	0	0	0	0	0	0	0	0	0	11		
23	0	0	0	0	0	0	0	0	0	0	0	0	0	0	0	0	0	0	0	0	0	0	0	0	0	0	0	0	0	0	0	0	0	0	0	0	0		
24	0	0	0	0	0	0	0	0	9	0	0	0	0	0	0	0	0	0	0	0	0	0	0	0	0	0	0	0	0	0	0	0	0	0	0	0	9		
25	0	0	0	0	0	0	0	0	15	0	0	0	0	0	0	0	0	0	0	0	0	0	0	0	0	0	0	0	0	0	0	0	0	0	0	0	15		
26	0	0	0	0	0	0	0	0	15	0	0	0	0	0	0	0	0	0	0	0	0	0	0	0	0	0	0	0	0	0	0	0	0	0	0	0	15		
27	0	0	0	0	0	0	0	0	25	0	0	0	0	0	0	0	0	0	0	0	0	0	0	0	0	0	0	0	0	0	0	0	0	0	0	0	25		
28	0	0	0	0	0	0	0	0	25	0	0	0	0	0	0	0	0	0	0	0	0	0	0	0	0	0	0	0	0	0	0	0	0	0	0	0	25		
29	0	0	0	0	0	0	0	0	26	0	0	0	0	0	0	0	0	0	0	0	0	0	0	0	0	0	0	0	0	0	0	0	0	0	0	0	26		
30	0	0	0	0	0	0	0	0	38	0	0	0	0	0	0	0	0	0	0	0	0	0	0	0	0	0	0	0	0	0	0	0	0	0	0	0	38		
31	0	0	0	0	0	0	0	0	43	0	0	0	0	0	0	0	0	0	0	0	0	0	0	0	0	0	0	0	0	0	0	0	0	0	0	0	43		
32	0	0	0	0	0	0	0	0	46	0	0	0	0	0	0	0	0	0	0	0	0	0	0	0	0	0	0	0	0	0	0	0	0	0	0	0	46		
33	0	0	0	0	0	0	0	0	45	0	0	0	0	0	0	0	0	0	0	0	0	0	0	0	0	0	0	0	0	0	0	0	0	0	0	0	45		
34	0	0	0	0	0	0	0	0	57	0	0	0	0	0	0	0	0	0	0	0	0	0	0	0	0	0	0	0	0	0	0	0	0	0	0	0	57		
35	0	0	0	0	0	0	0	0	65	0	0	0	0	0	0	0	0	0	0	0	0	0	0	0	0	0	0	0	0	0	0	0	0	0	0	0	65		
36	0	0	0	0	0	0	0	0	66	0	0	0	0	0	0	0	0	0	0	0	0	0	0	0	0	0	0	0	0	0	0	0	0	0	0	0	66		
37	0	0	0	0	0	0	0	0	72	0	0	0	0	0	0	0	0	0	0	0	0	0	0	0	0	0	0	0	0	0	0	0	0	0	0	0	72		
38	0	0	0	0	0	0	0	0	73	0	0	0	0	0	0	0	0	0	0	0	0	0	0	0	0	0	0	0	0	0	0	0	0	0	0	0	73		
39	0	0	0	0	0	0	0	0	86	0	0	0	0	0	0	0	0	0	0	0	0	0	0	0	0	0	0	0	0	0	0	0	0	0	0	0	86		
40	0	0	0	0	0	0	0	0	89	0	0	0	0	0	0	0	0	0	0	0	0	0	0	0	0	0	0	0	0	0	0	0	0	0	0	0	89		
41	0	0	0	0	0	0	0	0	97	0	0	0	0	0	0	0	0	0	0	0	0	0	0	0	0	0	0	0	0	0	0	0	0	0	0	0	97		
42	0	0	0	0	0	0	0	0	108	0	0	0	0	0	0	0	0	0	0	0	0	0	0	0	0	0	0	0	0	0	0	0	0	0	0	0	108		
43	0	0	0	0	0	0	0	0	97	0	0	0	0	0	0	0	0	0	0	0	0	0	0	0	0	0	0	0	0	0	0	0	0	0	0	0	97		
44	0	0	0	0	0	0	0	0	254	0	0	0	0	0	0	0	0	0	0	1	0	0	0	0	0	0	0	0	0	0	0	0	0	0	0	0	255		
45	0	0	0	0	0	0	0	0	13	0	0	0	0	0	0	0	0	0	0	0	0	0	0	0	0	0	0	0	0	0	0	0	0	0	0	0	13		
46	0	0	0	0	0	0	0	0	143	0	0	0	1	0	0	0	0	0	0	0	0	0	0	0	0	0	0	0	0	0	0	0	0	0	0	0	144		
47	0	0	0	0	0	0	0	0	142	0	0	0	0	0	0	0	0	0	0	0	0	0	0	0	0	0	0	0	0	0	0	0	0	0	0	0	142		
48	0	0	0	0	0	0	0	0	105	0	0	0	0	0	0	0	0	0	0	0	0	0	0	0	0	0	0	0	0	0	0	0	0	0	0	0	105		
49	0	0	0	0	0	0	0	0	98	0	0	0	0	0	0	0	0	0	0	0	0	0	0	0	0	0	0	0	0	0	0	0	0	0	0	0	98		
50	0	0	0	0	0	0	0	0	139	0	0	0	0	0	0	0	0	0	0	0	0	0	0	0	0	0	0	0	0	0	0	0	0	0	0	0	139		
51	0	0	0	0	0	0	0	0	112	0	0	0	0	0	0	0	2	0	0	0	0	0	0	0	0	0	0	0	0	0	0	0	0	0	0	0	114		
52	0	0	0	0	0	0	0	0	118	0	0	0	0	0	0	0	0	0	0	0	0	0	0	0	0	0	0	0	1	0	0	0	0	0	0	0	119		
53	0	0	0	0	0	0	0	0	109	0	0	0	0	0	0	0	2	0	0	0	0	0	0	0	0	0	0	0	1	0	0	0	0	0	0	0	112		
54	0	0	0	0	0	0	0	0	98	0	0	0	0	0	0	0	1	0	2	0	0	0	0	0	0	0	0	0	3	0	0	0	0	0	0	0	104		
55	0	0	0	0	0	0	0	0	150	0	0	0	0	0	0	0	3	0	0	0	0	0	0	0	0	0	0	0	2	0	0	0	0	0	0	0	155		
56	0	0	0	0	0	0	0	0	70	0	0	0	0	0	0	0	4	0	4	0	0	0	0	0	0	0	0	0	1	0	0	0	0	0	0	0	79		
57	0	0	0	0	0	0	0	0	52	0	0	0	0	0	0	0	3	0	5	0	0	0	0	0	0	0	0	0	3	0	0	0	0	0	0	0	63		
58	0	0	0	0	0	0	0	0	29	0	0	0	1	0	0	0	4	0	1	2	0	0	0	0	0	0	0	0	1	0	0	0	0	0	0	0	38		
59	0	0	0	0	0	0	0	0	44	0	0	0	0	0	0	0	7	0	5	0	0	0	0	0	0	0	0	0	1	0	0	0	0	0	0	0	57		
60	0	0	0	0	0	0	0	0	47	0	0	0	0	0	0	0	8	0	4	0	0	0	0	0	0	0	0	0	3	0	0	0	0	0	0	0	62		
61	0	0	1	0	0	0	0	0	35	0	0	0	0	0	0	0	9	0	8	2	0	0	0	0	0	0	0	0	1	0	0	0	0	0	0	1	57		
62	0	0	0	0	0	0	0	0	42	0	0	0	0	0	0	0	11	0	6	1	0	0	0	0	0	0	0	0	5	0	0	0	0	0	0	1	66		
63	0	0	0	0	0	0	0	0	32	0	0	0	1	0	0	0	12	0	17	0	0	0	0	0	0	0	0	0	6	0	0	0	0	0	0	4	72		
64	0	0	0	0	0	0	0	0	37	0	0	0	1	0	0	0	11	0	28	0	0	0	0	0	0	0	0	0	4	0	0	0	0	0	0	3	84		
65	0	0	1	0	0	0	0	0	31	0	0	0	0	0	0	0	15	0	27	0	0	0	0	0	0	0	0	0	3	1	0	0	0	0	0	2	80		
66	0	0	0	0	0	0	0	0	30	0	0	0	3	0	0	0	15	0	41	0	0	0	0	0	0	0	0	0	7	2	0	1	0	0	0	1	100		
67	0	0	0	0	0	0	0	0	28	0	0	0	2	0	0	0	17	0	49	0	0	0	0	0	0	0	0	0	2	2	0	0	0	0	1	2	103		
68	0	1	1	0	0	0	0	0	27	0	0	0	1	0	0	0	21	0	36	0	0	0	0	0	0	0	0	0	6	0	0	0	0	0	1	3	97		
69	0	0	0	0	0	0	0	0	23	0	0	1	9	0	0	0	49	0	133	1	0	0	0	0	0	0	0	0	1	0	0	1	0	0	0	4	222		
70	0	0	0	0	0	0	1	0	17	0	0	0	11	2	0	0	43	0	98	2	0	0	0	0	0	0	0	0	3	23	0	0	0	0	1	5	206		
71	0	0	0	0	0	0	0	0	22	0	0	0	3	0	0	0	54	0	167	3	0	0	0	0	0	0	0	0	6	7	0	1	0	0	4	2	269		
72	0	0	0	0	3	0	0	0	11	0	0	0	15	1	0	1	63	0	196	3	0	0	0	0	0	0	0	0	6	12	1	1	0	0	0	2	315		
73	1	0	0	1	0	0	0	0	7	0	0	1	13	2	1	0	75	0	189	4	0	1	0	0	0	0	0	0	1	37	0	0	0	0	2	10	345		
74	1	1	0	0	0	0	0	0	15	0	1	0	18	0	1	3	85	0	252	2	0	0	0	0	0	0	0	0	5	37	0	3	0	0	1	7	432		
75	0	0	0	0	1	0	0	0	9	0	1	0	12	3	0	0	97	0	173	1	0	0	0	0	0	0	0	0	3	15	0	4	0	0	18	10	347		
76	2	0	2	0	0	0	0	0	13	0	0	0	36	4	0	1	113	0	370	2	0	0	0	0	0	0	0	0	0	152	2	2	0	0	15	12	726		
77	0	0	0	2	1	0	3	0	9	0	0	0	21	1	1	0	129	0	347	4	0	2	0	0	0	0	0	0	6	21	4	1	0	0	22	16	590		
78	1	0	0	0	0	1	4	0	16	0	0	2	27	0	0	0	135	0	347	0	0	0	0	0	1	0	0	0	5	182	1	5	0	0	16	23	766		
79	1	0	1	1	9	3	1	0	8	0	1	2	69	0	0	0	147	0	473	1	0	0	0	0	1	0	0	0	5	107	2	2	1	2	34	42	913		
80	1	1	0	2	7	2	1	0	4	0	0	0	128	30	1	14	149	0	429	4	0	3	2	2	1	0	0	0	9	169	0	12	3	0	43	0	1017		
81	3	0	1	0	16	5	2	0	6	0	4	1	78	2	0	6	149	1	625	2	2	1	1	1	3	0	0	0	3	235	6	10	5	1	36	110	1315		
82	5	1	0	2	30	7	6	0	6	1	0	1	112	22	0	13	123	0	795	1	0	0	0	2	6	0	0	0	1	324	4	13	12	0	56	80	1623		
83	2	0	0	8	8	7	2	1	9	1	7	2	112	27	3	10	129	0	649	5	0	0	2	0	2	0	0	0	9	394	1	4	9	0	35	131	1569		
84	0	0	0	9	13	9	4	1	7	1	4	4	186	32	2	1	127	0	601	1	2	1	1	0	9	0	0	0	7	462	4	6	7	0	74	119	1694		
85	2	2	1	5	34	12	3	0	4	0	9	5	240	23	0	6	122	2	743	1	1	2	1	2	10	0	1	0	6	514	11	20	7	0	149	211	2149		
86	2	2	3	4	56	11	8	1	6	1	2	2	231	49	4	3	143	2	685	2	0	2	1	1	10	0	1	0	5	738	6	17	15	1	186	249	2449		
87	4	4	2	18	42	20	4	1	5	2	5	0	365	55	4	20	157	3	660	1	3	2	1	1	17	2	1	2	8	655	24	58	16	1	183	246	2592		
88	1	5	0	16	69	15	14	1	3	0	7	3	299	72	2	9	144	2	971	3	4	2	0	2	16	2	0	0	5	769	26	36	17	0	284	411	3210		
89	3	2	1	0	64	22	7	1	5	0	7	6	319	64	6	15	139	2	887	3	4	4	2	5	24	1	1	0	8	832	10	38	16	3	294	484	3279		
90	2	1	2	18	78	22	1	1	2	4	10	6	292	66	4	12	123	3	758	2	4	2	2	2	19	3	4	0	6	838	8	22	23	1	214	318	2873		
91	4	4	3	22	82	23	28	1	3	4	4	4	418	128	3	8	117	2	810	2	8	4	5	6	21	2	0	1	5	812	36	38	37	2	374	661	3682		
92	9	0	1	20	192	42	7	4	1	2	17	1	499	149	3	14	141	3	839	0	1	2	8	6	20	7	2	2	0	849	34	78	46	2	382	909	4292		
93	14	7	1	18	123	40	13	4	6	1	41	5	509	140	15	21	138	1	727	1	8	4	5	17	27	7	6	0	6	864	59	5	63	7	670	1059	4632		
94	5	3	2	12	183	58	29	2	10	2	0	6	471	145	6	13	124	13	760	6	13	10	0	8	22	6	5	0	5	950	43	54	79	0	652	915	4612		
95	42	3	7	10	132	60	49	4	4	6	25	0	2004	141	12	11	0	5	764	6	10	2	0	6	37	4	0	2	3	932	51	52	69	3	714	1104	6274		
96	25	6	4	18	140	73	44	5	3	7	27	14	1053	184	9	10	292	7	681	1	19	6	4	12	20	9	8	2	6	809	40	56	76	5	760	1344	5779		
97	22	3	2	18	164	54	49	7	2	3	8	5	518	92	32	7	151	3	527	3	15	8	15	10	29	2	5	2	3	674	28	19	73	4	644	1146	4347		
98	21	7	6	16	185	67	43	3	0	11	11	7	833	173	5	11	136	8	636	7	31	1	4	9	16	2	4	1	6	637	76	25	75	6	568	1342	4989		
99	20	7	3	23	403	114	57	6	2	4	29	7	1417	254	35	12	133	8	604	0	16	10	4	15	34	11	3	1	8	743	114	57	76	7	1038	1906	7181		
100	12	5	5	30	205	133	55	5	2	5	22	18	541	246	17	19	121	6	540	1	33	11	5	14	35	5	0	5	4	757	96	64	87	7	1034	1922	6067		
101	30	14	2	22	283	141	74	9	1	14	30	15	1341	266	33	40	117	15	612	4	20	8	3	17	29	13	3	0	4	683	106	51	96	5	1103	1873	7077		
102	21	3	2	24	496	115	60	8	3	11	25	17	987	171	40	26	122	9	570	3	39	4	5	31	26	18	3	6	0	605	77	49	98	12	1152	2087	6925		
103	19	7	3	18	327	68	84	8	0	20	18	11	635	129	34	21	125	6	619	10	40	6	15	12	35	12	5	1	6	510	17	26	95	4	839	1831	5616		
104	18	6	4	13	254	99	64	7	2	9	18	13	561	126	35	46	117	2	431	4	23	5	7	12	34	24	7	0	3	619	12	27	97	10	686	1500	4895		
105	20	3	0	18	303	105	63	2	0	3	22	5	574	170	31	26	111	13	564	7	36	11	3	0	31	18	6	2	5	517	20	0	98	10	744	1541	5082		
106	12	7	0	16	254	204	123	10	1	15	0	14	762	285	38	60	98	7	604	10	74	13	11	37	32	22	8	0	3	787	114	42	107	5	1044	2408	7227		
107	11	4	2	9	283	204	107	2	0	4	33	5	1438	315	37	10	94	7	578	17	43	3	17	24	32	28	6	7	4	617	170	73	115	18	842	4928	10087		
108	12	6	0	17	417	188	183	11	1290	13	15	13	753	299	23	27	92	12	525	12	37	6	11	20	30	34	4	14	1	585	130	43	125	9	1029	2299	8285		
109	16	7	4	21	306	217	116	11	0	9	18	9	761	242	43	24	89	9	575	6	60	0	8	26	28	41	4	2	2	565	67	42	126	8	935	3770	8167		
110	3	10	2	12	290	206	158	10	0	13	35	19	642	184	27	15	73	13	480	7	104	12	16	48	30	40	5	2	2	410	111	52	121	8	1115	1856	6131		
111	8	2	1	9	230	115	113	7	0	13	18	15	395	110	36	47	87	8	433	10	36	6	17	52	27	48	5	2	2	399	29	24	127	10	498	1772	4711		
112	9	8	1	10	145	113	110	6	0	10	33	11	547	194	47	8	91	5	454	15	26	0	16	45	21	44	6	4	1	430	40	7	123	10	559	1857	5006		
113	8	9	3	1	170	166	144	8	0	7	13	14	531	281	50	26	88	7	534	0	145	9	17	39	27	51	6	0	1	435	185	45	119	13	1172	2524	6848		
114	10	8	0	31	264	165	140	13	0	10	17	0	544	215	41	19	94	7	437	101	113	6	0	46	23	57	5	7	2	440	172	30	117	13	837	1721	5705		
115	5	6	1	14	228	407	172	8	0	9	23	12	516	227	37	12	90	2	464	30	99	11	28	42	35	42	7	10	0	367	84	51	115	6	727	3179	7066		
116	8	2	4	5	189	357	156	6	0	10	16	18	389	179	57	42	93	1	420	17	152	11	16	62	60	60	6	4	0	378	131	41	109	8	1005	1054	5066		
117	4	18	2	23	238	346	163	7	0	8	0	13	369	140	49	31	76	5	415	14	84	2	16	66	23	66	9	7	2	288	40	20	106	8	843	2172	5673		
118	6	1	2	6	177	189	95	8	1	10	0	0	242	110	48	23	60	0	260	3	46	0	12	28	25	66	3	1	1	0	2	8	99	11	420	1687	3650		
119	7	11	1	7	113	338	147	9	0	10	87	30	437	163	62	22	96	3	333	25	83	0	20	54	20	48	5	3	1	632	80	16	95	0	338	1369	4665		
120	5	10	4	20	124	474	152	9	0	16	208	22	367	202	73	8	71	6	382	13	135	2	26	72	25	72	8	3	2	453	81	27	92	19	909	2110	6202		
121	7	7	2	11	170	449	137	9	0	9	12	21	427	173	67	11	80	7	323	26	163	7	19	89	16	105	5	10	1	268	107	28	89	11	795	2611	6272		
122	6	4	2	4	93	435	188	11	0	15	17	12	289	0	73	8	71	7	285	17	127	2	39	108	18	101	5	0	1	281	124	15	93	0	674	2040	5165		
123	3	7	1	5	109	428	207	7	0	21	163	14	218	287	71	8	63	3	269	26	113	0	32	73	0	96	7	13	2	276	67	12	84	29	739	2062	5515		
124	6	12	0	7	62	421	175	13	0	10	308	9	166	74	83	31	65	4	474	34	89	0	23	76	16	53	7	7	0	164	16	32	78	0	621	1317	4453		
125	4	9	2	2	79	275	116	13	0	16	193	14	135	43	72	14	47	3	174	18	93	4	22	86	40	58	8	8	2	164	10	6	61	9	315	1297	3412		
126	2	14	0	2	80	296	172	10	0	18	5	7	306	139	195	19	74	3	195	11	117	0	24	58	0	76	7	7	2	185	90	4	64	15	288	1252	3737		
127	5	4	1	6	92	600	189	5	0	20	0	16	330	165	126	8	63	3	236	22	236	1	40	100	11	95	9	10	1	244	85	6	59	13	693	2144	5638		
128	6	9	1	2	323	615	189	6	0	19	49	17	278	123	89	23	78	1	369	8	197	0	38	89	15	86	9	5	1	213	87	22	64	11	649	2353	6044		
129	7	9	0	1	76	610	176	4	0	10	36	13	178	147	103	35	68	1	274	6	257	0	30	94	16	88	10	8	0	181	99	13	57	13	539	2239	5398		
130	5	11	0	5	106	751	161	9	0	21	50	21	243	103	95	13	55	5	243	44	199	4	24	87	9	98	10	17	0	227	135	8	48	21	626	1510	4964		
131	6	7	0	1	60	730	124	10	0	17	13	11	80	26	128	16	48	2	194	12	193	0	21	100	12	104	10	8	0	143	45	6	50	15	346	1614	4152		
132	8	0	0	3	75	496	178	8	0	18	410	11	70	22	97	14	51	5	165	8	112	4	28	75	9	88	7	8	0	123	5	6	47	15	268	734	3168		
133	5	5	0	2	51	396	122	11	0	16	18	8	263	116	87	18	45	6	179	22	108	7	39	72	9	94	9	12	2	176	31	5	55	17	210	1156	3372		
134	8	14	0	3	54	881	176	12	0	14	182	11	348	101	122	16	48	2	172	25	353	4	31	96	19	107	9	0	1	0	57	18	53	17	627	1703	5284		
																																							
																																							
																																							
																																							
																																							
																																							
																																							
																																							
																																							
																																							
																																							
																																							
																																							
																																							
																																							
																																							
																																							
																																							
																																							
																																							
																																							
																																							
																																							
																																							
																																							
																																							
																																							
																																							
																																							
																																							
																																							
																																							
																																							
